WWWWWWWWWW
WB     bSW
W  A   WWW
WXWW    WW
W    T   W
WWWWWW  WW    
W        W
WWWWWWWWWW
W     RRR   
WWWWWWWWWW