WWWWWWWWWW
W S  Rb AW
W WWWWW WW
W C T b CW
W A YRR YW
W T W X WW
W  U K U W
W  HHH   W
W   C  B W
WWWWWWWWWW
