WWWWWWWWWW
W  R A C W
W Y C WWWW
W W   T   
W W RRR  W
W S  A C W
W  HHH   W
W   U    W
W    B   W
WWWWWWWWWW
