WWWWWWWWWW
W  B   A W
W HHHH   W
W        W
W    WWXWW 
W S  W    
W    W   W
W        W
W        W
WWWWWWWWWW