WWWWWWWWWW
WA S     W
W HHHHT  W
W     b  W
W    WWXWW
W    W    
W B WW   W
W    W   W
WY  AW   W
WWWWWWWWWW
