WWWWWWWWWW
W  B   A W
W HHHH   W
W    b Y W
W  T WWXWW
W    W   E
W S WW U W
W        W
W R A    W
WWWWWWWWWW
