WWWWWWWWWW
W S  R A W
W WWWWW WW
W C T b C W
W A YRR Y W
W T W X W W
W  U K U  W
W  HHHV   W
W   C  B  W
WWWWWWWWWW
