WWWWWWWWWW
W  B   A W
W HHHH   W
W      Y W
W  T WWXWW
W    W   E
W S  W U W
W        W
W R A    W
WWWWWWWWWW
