WWWWWWWWWW
W  B     W
W HHHH   W
W  A b   W
W  T WWXWW
W    W   
W S  W   W
W    A   W
W   A AA W
WWWWWWWWWW