WWWWWWWWWW
WB       W
WWWWWWW WW
W        W
W  b     W 
WWWW     W
W     TU W
WWWXXWWWWW
W       SW
WWWWWWWWWW