WWWWWWWWWW
W  S     W
W  HHHH  W
W        W
W  C WWXWW
W    W    
W  B W   W
W        W
W    AA  W
WWWWWWWWWW