WWWWWWWWWW
WA S     W
W HHHH   W
WY    b  W
WXXX WWWWW
WB    WR    
W  TWW   W
W    W   W
W    W U W
WWWWWWWWWW
