WWWWWWWWWW
WB T    AW
W  WWW   W
W    H   W
W    W   W
W    W    
W    b   W 
W        W      
WS   A  YW
WWWWWWWWWW